1 1 1 1 1 1 1
1 1 1 1 1 1 1
4 4 4 4 4 4 4
4 2 0 0 2 4 4
3 3 0 0 3 4 4
1 1 1 1 1 1 1