1 1 1 1 1 1 1
5 5 5 5 5 5 5
4 4 4 4 4 4 4
4 1 0 0 2 4 4
3 3 0 0 3 4 4
1 1 1 1 1 1 1