5 3 2 3 4 5 2
5 2 5 3 5 4 5
4 1 0 1 4 4 3
4 1 2 0 4 1 4
3 3 0 3 3 4 4
1 2 3 4 2 2 3